{
    "current_level": 0,
    "levels": [{
            "id": 0,
            "width": 28,
            "height": 31,
            "super_pac_gum": {
                "duration": 10
            },
            "pac-man": {
                "id": 1,
                "start_pos": {
                    "x": 13,
                    "y": 23
                }
            },
            "ghost": [{
                "id": 1,
                "speed": 1,
                "start_pos": {
                    "x": 0,
                    "y": 0
                }
            }, {
                "id": 2,
                "speed": 1,
                "start_pos": {
                    "x": 0,
                    "y": 0
                }
            }, {
                "id": 3,
                "speed": 1,
                "start_pos": {
                    "x": 0,
                    "y": 0
                }
            }, {
                "id": 4,
                "speed": 1,
                "start_pos": {
                    "x": 0,
                    "y": 0
                }
            }],
            "map": [
				[2, 11, 11, 11, 11, 11, 11, 11, 11, 11, 11, 11, 11, 36, 35, 11, 11, 11, 11, 11, 11, 11, 11, 11, 11, 11, 11, 1],
                [4, 39, 39, 39, 39, 39, 39, 39, 39, 39, 39, 39, 39, 22, 21, 39, 39, 39, 39, 39, 39, 39, 39, 39, 39, 39, 39, 3],
                [4, 39, 20, 14, 14, 19, 39, 20, 14, 14, 14, 19, 39, 22, 21, 39, 20, 14, 14, 14, 19, 39, 20, 14, 14, 19, 39, 3],
                [4, 40, 22, 0, 0, 21, 39, 22, 0, 0, 0, 21, 39, 22, 21, 39, 22, 0, 0, 0, 21, 39, 22, 0, 0, 21, 40, 3],
                [4, 39, 24, 13, 13, 23, 39, 24, 13, 13, 13, 23, 39, 24, 23, 39, 24, 13, 13, 13, 23, 39, 24, 13, 13, 23, 39, 3],
                [4, 39, 39, 39, 39, 39, 39, 39, 39, 39, 39, 39, 39, 39, 39, 39, 39, 39, 39, 39, 39, 39, 39, 39, 39, 39, 39, 3],
                [4, 39, 20, 14, 14, 19, 39, 20, 19, 39, 20, 14, 14, 14, 14, 14, 14, 19, 39, 20, 19, 39, 20, 14, 14, 19, 39, 3],
                [4, 39, 24, 13, 13, 23, 39, 22, 21, 39, 24, 13, 13, 32, 31, 13, 13, 23, 39, 22, 21, 39, 24, 13, 13, 23, 39, 3],
                [4, 39, 39, 39, 39, 39, 39, 22, 21, 39, 39, 39, 39, 22, 21, 39, 39, 39, 39, 22, 21, 39, 39, 39, 39, 39, 39, 3],
                [6, 12, 12, 12, 12, 19, 39, 22, 33, 14, 14, 19, 39, 22, 21, 39, 20, 14, 14, 34, 21, 39, 20, 12, 12, 12, 12, 5],
                [0, 0, 0, 0, 0, 4, 39, 22, 31, 13, 13, 23, 39, 24, 23, 39, 24, 13, 13, 32, 21, 39, 3, 0, 0, 0, 0, 0],
                [0, 0, 0, 0, 0, 4, 39, 22, 21, 39, 39, 39, 39, 39, 39, 39, 39, 39, 39, 22, 21, 39, 3, 0, 0, 0, 0, 0],
                [0, 0, 0, 0, 0, 4, 39, 22, 21, 39, 26, 12, 30, 37, 37, 29, 12, 25, 39, 22, 21, 39, 3, 0, 0, 0, 0, 0],
                [11, 11, 11, 11, 11, 23, 39, 24, 23, 39, 3, 0, 0, 0, 0, 0, 0, 4, 39, 24, 23, 39, 24, 11, 11, 11, 11, 11],
                [0, 0, 0, 0, 0, 0, 39, 39, 39, 39, 3, 0, 0, 0, 0, 0, 0, 4, 39, 39, 39, 39, 0, 0, 0, 0, 0, 0],
                [12, 12, 12, 12, 12, 19, 39, 20, 19, 39, 3, 0, 0, 0, 0, 0, 0, 4, 39, 20, 19, 39, 20, 12, 12, 12, 12, 12],
                [0, 0, 0, 0, 0, 4, 39, 22, 21, 39, 28, 11, 11, 11, 11, 11, 11, 27, 39, 22, 21, 39, 3, 0, 0, 0, 0, 0],
                [0, 0, 0, 0, 0, 4, 39, 22, 21, 39, 39, 39, 39, 39, 39, 39, 39, 39, 39, 22, 21, 39, 3, 0, 0, 0, 0, 0],
                [0, 0, 0, 0, 0, 4, 39, 22, 21, 39, 20, 14, 14, 14, 14, 14, 14, 19, 39, 22, 21, 39, 3, 0, 0, 0, 0, 0],
                [2, 11, 11, 11, 11, 23, 39, 24, 23, 39, 24, 13, 13, 32, 31, 13, 13, 23, 39, 24, 23, 39, 24, 11, 11, 11, 11, 1],
                [4, 39, 39, 39, 39, 39, 39, 39, 39, 39, 39, 39, 39, 22, 21, 39, 39, 39, 39, 39, 39, 39, 39, 39, 39, 39, 39, 3],
                [4, 39, 20, 14, 14, 19, 39, 20, 14, 14, 14, 19, 39, 22, 21, 39, 20, 14, 14, 14, 19, 39, 20, 14, 14, 19, 39, 3],
                [4, 39, 24, 13, 32, 21, 39, 24, 13, 13, 13, 23, 39, 24, 23, 39, 24, 13, 13, 13, 23, 39, 22, 31, 13, 23, 39, 3],
                [4, 39, 39, 39, 22, 21, 39, 39, 39, 39, 39, 39, 39, 39, 39, 39, 39, 39, 39, 39, 39, 39, 22, 21, 39, 39, 39, 3],
                [8, 14, 19, 39, 22, 21, 39, 20, 19, 39, 20, 14, 14, 14, 14, 14, 14, 19, 39, 20, 19, 39, 22, 21, 39, 20, 14, 7],
                [10, 13, 23, 39, 24, 23, 39, 22, 21, 39, 24, 13, 13, 32, 31, 13, 13, 23, 39, 22, 21, 39, 24, 23, 39, 24, 13, 9],
                [4, 40, 39, 39, 39, 39, 39, 22, 21, 39, 39, 39, 39, 22, 21, 39, 39, 39, 39, 22, 21, 39, 39, 39, 39, 39, 40, 3],
                [4, 39, 20, 14, 14, 14, 14, 23, 24, 14, 14, 19, 39, 22, 21, 39, 20, 14, 14, 23, 24, 14, 14, 14, 14, 19, 39, 3],
                [4, 39, 24, 13, 13, 13, 13, 13, 13, 13, 13, 23, 39, 24, 23, 39, 24, 13, 13, 13, 13, 13, 13, 13, 13, 23, 39, 3],
				[4, 39, 39, 39, 39, 39, 39, 39, 39, 39, 39, 39, 39, 39, 39, 39, 39, 39, 39, 39, 39, 39, 39, 39, 39, 39, 39, 3],
                [6, 12, 12, 12, 12, 12, 12, 12, 12, 12, 12, 12, 12, 12, 12, 12, 12, 12, 12, 12, 12, 12, 12, 12, 12, 12, 12, 5]
            ]
        },
        {
            "id": 1,
            "width": 28,
            "height": 31,
            "super_pac_gum": {
                "duration": 10
            },
            "pac-man": {
                "id": 1,
                "start_pos": {
                    "x": 13,
                    "y": 23
                }
            },
            "ghost": [{
                "id": 1,
                "start_pos": {
                    "x": 0,
                    "y": 0
                }
            }, {
                "id": 2,
                "start_pos": {
                    "x": 0,
                    "y": 0
                }
            }, {
                "id": 3,
                "start_pos": {
                    "x": 0,
                    "y": 0
                }
            }, {
                "id": 4,
                "start_pos": {
                    "x": 0,
                    "y": 0
                }
            }],
            "map": [
				[2, 11, 11, 11, 11, 11, 11, 11, 11, 11, 11, 11, 11, 36, 35, 11, 11, 11, 11, 11, 11, 11, 11, 11, 11, 11, 11, 1],
                [4, 39, 39, 0, 0, 0, 0, 0, 0, 0, 0, 0, 0, 22, 21, 0, 0, 0, 0, 0, 0, 0, 0, 0, 0, 0, 0, 3],
                [4, 0, 20, 14, 14, 19, 0, 20, 14, 14, 14, 19, 0, 22, 21, 0, 20, 14, 14, 14, 19, 0, 20, 14, 14, 19, 0, 3],
                [4, 0, 22, 0, 0, 21, 0, 22, 0, 0, 0, 21, 0, 22, 21, 0, 22, 0, 0, 0, 21, 0, 22, 0, 0, 21, 0, 3],
                [4, 0, 24, 13, 13, 23, 0, 24, 13, 13, 13, 23, 0, 24, 23, 0, 24, 13, 13, 13, 23, 0, 24, 13, 13, 23, 0, 3],
                [4, 0, 0, 0, 0, 0, 0, 0, 0, 0, 0, 0, 0, 0, 0, 0, 0, 0, 0, 0, 0, 0, 0, 0, 0, 0, 0, 3],
                [4, 0, 20, 14, 14, 19, 0, 20, 19, 0, 20, 14, 14, 14, 14, 14, 14, 19, 0, 20, 19, 0, 20, 14, 14, 19, 0, 3],
                [4, 0, 24, 13, 13, 23, 0, 22, 21, 0, 24, 13, 13, 32, 31, 13, 13, 23, 0, 22, 21, 0, 24, 13, 13, 23, 0, 3],
                [4, 0, 0, 0, 0, 0, 0, 22, 21, 0, 0, 0, 0, 22, 21, 0, 0, 0, 0, 22, 21, 0, 0, 0, 0, 0, 0, 3],
                [6, 12, 12, 12, 12, 19, 0, 22, 33, 14, 14, 19, 0, 22, 21, 0, 20, 14, 14, 34, 21, 0, 20, 12, 12, 12, 12, 5],
                [0, 0, 0, 0, 0, 4, 0, 22, 31, 13, 13, 23, 0, 24, 23, 0, 24, 13, 13, 32, 21, 0, 3, 0, 0, 0, 0, 0],
                [0, 0, 0, 0, 0, 4, 0, 22, 21, 0, 0, 0, 0, 0, 0, 0, 0, 0, 0, 22, 21, 0, 3, 0, 0, 0, 0, 0],
                [0, 0, 0, 0, 0, 4, 0, 22, 21, 0, 26, 12, 30, 37, 37, 29, 12, 25, 0, 22, 21, 0, 3, 0, 0, 0, 0, 0],
                [11, 11, 11, 11, 11, 23, 0, 24, 23, 0, 3, 0, 0, 0, 0, 0, 0, 4, 0, 24, 23, 0, 24, 11, 11, 11, 11, 11],
                [0, 0, 0, 0, 0, 0, 0, 0, 0, 0, 3, 0, 0, 0, 0, 0, 0, 4, 0, 0, 0, 0, 0, 0, 0, 0, 0, 0],
                [12, 12, 12, 12, 12, 19, 0, 20, 19, 0, 3, 0, 0, 0, 0, 0, 0, 4, 0, 20, 19, 0, 20, 12, 12, 12, 12, 12],
                [0, 0, 0, 0, 0, 4, 0, 22, 21, 0, 28, 11, 11, 11, 11, 11, 11, 27, 0, 22, 21, 0, 3, 0, 0, 0, 0, 0],
                [0, 0, 0, 0, 0, 4, 0, 22, 21, 0, 0, 0, 0, 0, 0, 0, 0, 0, 0, 22, 21, 0, 3, 0, 0, 0, 0, 0],
                [0, 0, 0, 0, 0, 4, 0, 22, 21, 0, 20, 14, 14, 14, 14, 14, 14, 19, 0, 22, 21, 0, 3, 0, 0, 0, 0, 0],
                [2, 11, 11, 11, 11, 23, 0, 24, 23, 0, 24, 13, 13, 32, 31, 13, 13, 23, 0, 24, 23, 0, 24, 11, 11, 11, 11, 1],
                [4, 0, 0, 0, 0, 0, 0, 0, 0, 0, 0, 0, 0, 22, 21, 0, 0, 0, 0, 0, 0, 0, 0, 0, 0, 0, 0, 3],
                [4, 0, 20, 14, 14, 19, 0, 20, 14, 14, 14, 19, 0, 22, 21, 0, 20, 14, 14, 14, 19, 0, 20, 14, 14, 19, 0, 3],
                [4, 0, 24, 13, 32, 21, 0, 24, 13, 13, 13, 23, 0, 24, 23, 0, 24, 13, 13, 13, 23, 0, 22, 31, 13, 23, 0, 3],
                [4, 0, 0, 0, 22, 21, 0, 0, 0, 0, 0, 0, 0, 0, 0, 0, 0, 0, 0, 0, 0, 0, 22, 21, 0, 0, 0, 3],
                [8, 14, 19, 0, 22, 21, 0, 20, 19, 0, 20, 14, 14, 14, 14, 14, 14, 19, 0, 20, 19, 0, 22, 21, 0, 20, 14, 7],
                [10, 13, 23, 0, 24, 23, 0, 22, 21, 0, 24, 13, 13, 32, 31, 13, 13, 23, 0, 22, 21, 0, 24, 23, 0, 24, 13, 9],
                [4, 0, 0, 0, 0, 0, 0, 22, 21, 0, 0, 0, 0, 22, 21, 0, 0, 0, 0, 22, 21, 0, 0, 0, 0, 0, 0, 3],
                [4, 0, 20, 14, 14, 14, 14, 23, 24, 14, 14, 19, 0, 22, 21, 0, 20, 14, 14, 23, 24, 14, 14, 14, 14, 19, 0, 3],
                [4, 0, 24, 13, 13, 13, 13, 13, 13, 13, 13, 23, 0, 24, 23, 0, 24, 13, 13, 13, 13, 13, 13, 13, 13, 23, 0, 3],
				[4, 0, 0, 0, 0, 0, 0, 0, 0, 0, 0, 0, 0, 0, 0, 0, 0, 0, 0, 0, 0, 0, 0, 0, 0, 0, 0, 3],
                [6, 12, 12, 12, 12, 12, 12, 12, 12, 12, 12, 12, 12, 12, 12, 12, 12, 12, 12, 12, 12, 12, 12, 12, 12, 12, 12, 5]
            ]
        },
        {
            "id": 2,
            "width": 28,
            "height": 31,
            "super_pac_gum": {
                "duration": 10
            },
            "pac-man": {
                "id": 1,
                "start_pos": {
                    "x": 13,
                    "y": 23
                }
            },
            "ghost": [{
                "id": 1,
                "start_pos": {
                    "x": 0,
                    "y": 0
                }
            }, {
                "id": 2,
                "start_pos": {
                    "x": 0,
                    "y": 0
                }
            }, {
                "id": 3,
                "start_pos": {
                    "x": 0,
                    "y": 0
                }
            }, {
                "id": 4,
                "start_pos": {
                    "x": 0,
                    "y": 0
                }
            }],
            "map": [
				[2, 11, 11, 11, 11, 11, 11, 11, 11, 11, 11, 11, 11, 36, 35, 11, 11, 11, 11, 11, 11, 11, 11, 11, 11, 11, 11, 1],
                [4, 39, 39, 0, 0, 0, 0, 0, 0, 0, 0, 0, 0, 22, 21, 0, 0, 0, 0, 0, 0, 0, 0, 0, 0, 0, 0, 3],
                [4, 0, 20, 14, 14, 19, 0, 20, 14, 14, 14, 19, 0, 22, 21, 0, 20, 14, 14, 14, 19, 0, 20, 14, 14, 19, 0, 3],
                [4, 0, 22, 0, 0, 21, 0, 22, 0, 0, 0, 21, 0, 22, 21, 0, 22, 0, 0, 0, 21, 0, 22, 0, 0, 21, 0, 3],
                [4, 0, 24, 13, 13, 23, 0, 24, 13, 13, 13, 23, 0, 24, 23, 0, 24, 13, 13, 13, 23, 0, 24, 13, 13, 23, 0, 3],
                [4, 0, 0, 0, 0, 0, 0, 0, 0, 0, 0, 0, 0, 0, 0, 0, 0, 0, 0, 0, 0, 0, 0, 0, 0, 0, 0, 3],
                [4, 0, 20, 14, 14, 19, 0, 20, 19, 0, 20, 14, 14, 14, 14, 14, 14, 19, 0, 20, 19, 0, 20, 14, 14, 19, 0, 3],
                [4, 0, 24, 13, 13, 23, 0, 22, 21, 0, 24, 13, 13, 32, 31, 13, 13, 23, 0, 22, 21, 0, 24, 13, 13, 23, 0, 3],
                [4, 0, 0, 0, 0, 0, 0, 22, 21, 0, 0, 0, 0, 22, 21, 0, 0, 0, 0, 22, 21, 0, 0, 0, 0, 0, 0, 3],
                [6, 12, 12, 12, 12, 19, 0, 22, 33, 14, 14, 19, 0, 22, 21, 0, 20, 14, 14, 34, 21, 0, 20, 12, 12, 12, 12, 5],
                [0, 0, 0, 0, 0, 4, 0, 22, 31, 13, 13, 23, 0, 24, 23, 0, 24, 13, 13, 32, 21, 0, 3, 0, 0, 0, 0, 0],
                [0, 0, 0, 0, 0, 4, 0, 22, 21, 0, 0, 0, 0, 0, 0, 0, 0, 0, 0, 22, 21, 0, 3, 0, 0, 0, 0, 0],
                [0, 0, 0, 0, 0, 4, 0, 22, 21, 0, 26, 12, 30, 37, 37, 29, 12, 25, 0, 22, 21, 0, 3, 0, 0, 0, 0, 0],
                [11, 11, 11, 11, 11, 23, 0, 24, 23, 0, 3, 0, 0, 0, 0, 0, 0, 4, 0, 24, 23, 0, 24, 11, 11, 11, 11, 11],
                [0, 0, 0, 0, 0, 0, 0, 0, 0, 0, 3, 0, 0, 0, 0, 0, 0, 4, 0, 0, 0, 0, 0, 0, 0, 0, 0, 0],
                [12, 12, 12, 12, 12, 19, 0, 20, 19, 0, 3, 0, 0, 0, 0, 0, 0, 4, 0, 20, 19, 0, 20, 12, 12, 12, 12, 12],
                [0, 0, 0, 0, 0, 4, 0, 22, 21, 0, 28, 11, 11, 11, 11, 11, 11, 27, 0, 22, 21, 0, 3, 0, 0, 0, 0, 0],
                [0, 0, 0, 0, 0, 4, 0, 22, 21, 0, 0, 0, 0, 0, 0, 0, 0, 0, 0, 22, 21, 0, 3, 0, 0, 0, 0, 0],
                [0, 0, 0, 0, 0, 4, 0, 22, 21, 0, 20, 14, 14, 14, 14, 14, 14, 19, 0, 22, 21, 0, 3, 0, 0, 0, 0, 0],
                [2, 11, 11, 11, 11, 23, 0, 24, 23, 0, 24, 13, 13, 32, 31, 13, 13, 23, 0, 24, 23, 0, 24, 11, 11, 11, 11, 1],
                [4, 0, 0, 0, 0, 0, 0, 0, 0, 0, 0, 0, 0, 22, 21, 0, 0, 0, 0, 0, 0, 0, 0, 0, 0, 0, 0, 3],
                [4, 0, 20, 14, 14, 19, 0, 20, 14, 14, 14, 19, 0, 22, 21, 0, 20, 14, 14, 14, 19, 0, 20, 14, 14, 19, 0, 3],
                [4, 0, 24, 13, 32, 21, 0, 24, 13, 13, 13, 23, 0, 24, 23, 0, 24, 13, 13, 13, 23, 0, 22, 31, 13, 23, 0, 3],
                [4, 0, 0, 0, 22, 21, 0, 0, 0, 0, 0, 0, 0, 0, 0, 0, 0, 0, 0, 0, 0, 0, 22, 21, 0, 0, 0, 3],
                [8, 14, 19, 0, 22, 21, 0, 20, 19, 0, 20, 14, 14, 14, 14, 14, 14, 19, 0, 20, 19, 0, 22, 21, 0, 20, 14, 7],
                [10, 13, 23, 0, 24, 23, 0, 22, 21, 0, 24, 13, 13, 32, 31, 13, 13, 23, 0, 22, 21, 0, 24, 23, 0, 24, 13, 9],
                [4, 0, 0, 0, 0, 0, 0, 22, 21, 0, 0, 0, 0, 22, 21, 0, 0, 0, 0, 22, 21, 0, 0, 0, 0, 0, 0, 3],
                [4, 0, 20, 14, 14, 14, 14, 23, 24, 14, 14, 19, 0, 22, 21, 0, 20, 14, 14, 23, 24, 14, 14, 14, 14, 19, 0, 3],
                [4, 0, 24, 13, 13, 13, 13, 13, 13, 13, 13, 23, 0, 24, 23, 0, 24, 13, 13, 13, 13, 13, 13, 13, 13, 23, 0, 3],
				[4, 0, 0, 0, 0, 0, 0, 0, 0, 0, 0, 0, 0, 0, 0, 0, 0, 0, 0, 0, 0, 0, 0, 0, 0, 0, 0, 3],
                [6, 12, 12, 12, 12, 12, 12, 12, 12, 12, 12, 12, 12, 12, 12, 12, 12, 12, 12, 12, 12, 12, 12, 12, 12, 12, 12, 5]
            ]
        }
    ]
}
