{
    "width": 28,
    "height": 31,
    "pac-man": {
        "start_pos": {
            "x": 13,
            "y": 23
        }
    },
    "ghost": [{
        "name": "BLINKY",
        "start_pos": {
            "x": 13,
            "y": 11
        }
    }, {
        "name": "INKY",
        "start_pos": {
            "x": 11,
            "y": 15
        }
    }, {
        "name": "PINKY",
        "start_pos": {
            "x": 13,
            "y": 15
        }
    }, {
        "name": "CLYDE",
        "start_pos": {
            "x": 15,
            "y": 15
        }
    }],
    "map": [
        [2, 11, 11, 11, 11, 11, 11, 11, 11, 11, 11, 11, 11, 36, 35, 11, 11, 11, 11, 11, 11, 11, 11, 11, 11, 11, 11, 1],
        [4, 39, 39, 39, 39, 39, 39, 39, 39, 39, 39, 39, 39, 22, 21, 39, 39, 39, 39, 39, 39, 39, 39, 39, 39, 39, 39, 3],
        [4, 39, 20, 14, 14, 19, 39, 20, 14, 14, 14, 19, 39, 22, 21, 39, 20, 14, 14, 14, 19, 39, 20, 14, 14, 19, 39, 3],
        [4, 40, 22, 0, 0, 21, 39, 22, 0, 0, 0, 21, 39, 22, 21, 39, 22, 0, 0, 0, 21, 39, 22, 0, 0, 21, 40, 3],
        [4, 39, 24, 13, 13, 23, 39, 24, 13, 13, 13, 23, 39, 24, 23, 39, 24, 13, 13, 13, 23, 39, 24, 13, 13, 23, 39, 3],
        [4, 39, 39, 39, 39, 39, 39, 39, 39, 39, 39, 39, 39, 39, 39, 39, 39, 39, 39, 39, 39, 39, 39, 39, 39, 39, 39, 3],
        [4, 39, 20, 14, 14, 19, 39, 20, 19, 39, 20, 14, 14, 14, 14, 14, 14, 19, 39, 20, 19, 39, 20, 14, 14, 19, 39, 3],
        [4, 39, 24, 13, 13, 23, 39, 22, 21, 39, 24, 13, 13, 32, 31, 13, 13, 23, 39, 22, 21, 39, 24, 13, 13, 23, 39, 3],
        [4, 39, 39, 39, 39, 39, 39, 22, 21, 39, 39, 39, 39, 22, 21, 39, 39, 39, 39, 22, 21, 39, 39, 39, 39, 39, 39, 3],
        [6, 12, 12, 12, 12, 19, 39, 22, 33, 14, 14, 19, 0, 22, 21, 0, 20, 14, 14, 34, 21, 39, 20, 12, 12, 12, 12, 5],
        [325, 325, 325, 325, 325, 4, 39, 22, 31, 13, 13, 23, 0, 24, 23, 0, 24, 13, 13, 32, 21, 39, 3, 325, 325, 325, 325, 325],
        [325, 325, 325, 325, 325, 4, 39, 22, 21, 0, 0, 0, 0, 0, 0, 0, 0, 0, 0, 22, 21, 39, 3, 325, 325, 325, 325, 325],
        [325, 325, 325, 325, 325, 4, 39, 22, 21, 0, 26, 12, 30, 37, 37, 29, 12, 25, 0, 22, 21, 39, 3, 325, 325, 325, 325, 325],
        [11, 11, 11, 11, 11, 23, 39, 24, 23, 0, 3, 38, 38, 38, 38, 38, 38, 4, 0, 24, 23, 39, 24, 11, 11, 11, 11, 11],
        [325, 325, 325, 325, 325, 325, 39, 0, 0, 0, 3, 38, 38, 38, 38, 38, 38, 4, 0, 0, 0, 39, 325, 325, 325, 325, 325, 325],
        [12, 12, 12, 12, 12, 19, 39, 20, 19, 0, 3, 38, 38, 38, 38, 38, 38, 4, 0, 20, 19, 39, 20, 12, 12, 12, 12, 12],
        [325, 325, 325, 325, 325, 4, 39, 22, 21, 0, 28, 11, 11, 11, 11, 11, 11, 27, 0, 22, 21, 39, 3, 325, 325, 325, 325, 325],
        [325, 325, 325, 325, 325, 4, 39, 22, 21, 0, 0, 0, 0, 0, 0, 0, 0, 0, 0, 22, 21, 39, 3, 325, 325, 325, 325, 325],
        [325, 325, 325, 325, 325, 4, 39, 22, 21, 0, 20, 14, 14, 14, 14, 14, 14, 19, 0, 22, 21, 39, 3, 325, 325, 325, 325, 325],
        [2, 11, 11, 11, 11, 23, 39, 24, 23, 0, 24, 13, 13, 32, 31, 13, 13, 23, 0, 24, 23, 39, 24, 11, 11, 11, 11, 1],
        [4, 39, 39, 39, 39, 39, 39, 39, 39, 39, 39, 39, 39, 22, 21, 39, 39, 39, 39, 39, 39, 39, 39, 39, 39, 39, 39, 3],
        [4, 39, 20, 14, 14, 19, 39, 20, 14, 14, 14, 19, 39, 22, 21, 39, 20, 14, 14, 14, 19, 39, 20, 14, 14, 19, 39, 3],
        [4, 39, 24, 13, 32, 21, 39, 24, 13, 13, 13, 23, 39, 24, 23, 39, 24, 13, 13, 13, 23, 39, 22, 31, 13, 23, 39, 3],
        [4, 40, 39, 39, 22, 21, 39, 39, 39, 39, 39, 39, 39, 39, 39, 39, 39, 39, 39, 39, 39, 39, 22, 21, 39, 39, 40, 3],
        [8, 14, 19, 39, 22, 21, 39, 20, 19, 39, 20, 14, 14, 14, 14, 14, 14, 19, 39, 20, 19, 39, 22, 21, 39, 20, 14, 7],
        [10, 13, 23, 39, 24, 23, 39, 22, 21, 39, 24, 13, 13, 32, 31, 13, 13, 23, 39, 22, 21, 39, 24, 23, 39, 24, 13, 9],
        [4, 39, 39, 39, 39, 39, 39, 22, 21, 39, 39, 39, 39, 22, 21, 39, 39, 39, 39, 22, 21, 39, 39, 39, 39, 39, 39, 3],
        [4, 39, 20, 14, 14, 14, 14, 23, 24, 14, 14, 19, 39, 22, 21, 39, 20, 14, 14, 23, 24, 14, 14, 14, 14, 19, 39, 3],
        [4, 39, 24, 13, 13, 13, 13, 13, 13, 13, 13, 23, 39, 24, 23, 39, 24, 13, 13, 13, 13, 13, 13, 13, 13, 23, 39, 3],
        [4, 39, 39, 39, 39, 39, 39, 39, 39, 39, 39, 39, 39, 39, 39, 39, 39, 39, 39, 39, 39, 39, 39, 39, 39, 39, 39, 3],
        [6, 12, 12, 12, 12, 12, 12, 12, 12, 12, 12, 12, 12, 12, 12, 12, 12, 12, 12, 12, 12, 12, 12, 12, 12, 12, 12, 5]
    ]
}