{
    "current_level": 0,
    "levels": [{
            "id": 0,
            "width": 28,
            "height": 31,
            "super_pac_gum": {
                "duration": 10
            },
            "pac-man": {
                "id": 1,
                "start_pos": {
                    "x": 0,
                    "y": 0
                }
            },
            "ghost": [{
                "id": 1,
                "speed": 1,
                "start_pos": {
                    "x": 0,
                    "y": 0
                }
            }, {
                "id": 2,
                "speed": 1,
                "start_pos": {
                    "x": 0,
                    "y": 0
                }
            }, {
                "id": 3,
                "speed": 1,
                "start_pos": {
                    "x": 0,
                    "y": 0
                }
            }, {
                "id": 4,
                "speed": 1,
                "start_pos": {
                    "x": 0,
                    "y": 0
                }
            }],
            "map": [
				[02, 11, 11, 11, 11, 11, 11, 11, 11, 11, 11, 11, 11, 36, 35, 11, 11, 11, 11, 11, 11, 11, 11, 11, 11, 11, 11, 01],
                [04, 39, 39, 39, 39, 39, 39, 39, 39, 39, 39, 39, 39, 22, 21, 39, 39, 39, 39, 39, 39, 39, 39, 39, 39, 39, 39, 03],
                [04, 39, 20, 14, 14, 19, 39, 20, 14, 14, 14, 19, 39, 22, 21, 39, 20, 14, 14, 14, 19, 39, 20, 14, 14, 19, 39, 03],
                [04, 40, 22, 00, 00, 21, 39, 22, 00, 00, 00, 21, 39, 22, 21, 39, 22, 00, 00, 00, 21, 39, 22, 00, 00, 21, 40, 03],
                [04, 39, 24, 13, 13, 23, 39, 24, 13, 13, 13, 23, 39, 24, 23, 39, 24, 13, 13, 13, 23, 39, 24, 13, 13, 23, 39, 03],
                [04, 39, 39, 39, 39, 39, 39, 39, 39, 39, 39, 39, 39, 39, 39, 39, 39, 39, 39, 39, 39, 39, 39, 39, 39, 39, 39, 03],
                [04, 39, 20, 14, 14, 19, 39, 20, 19, 39, 20, 14, 14, 14, 14, 14, 14, 19, 39, 20, 19, 39, 20, 14, 14, 19, 39, 03],
                [04, 39, 24, 13, 13, 23, 39, 22, 21, 39, 24, 13, 13, 32, 31, 13, 13, 23, 39, 22, 21, 39, 24, 13, 13, 23, 39, 03],
                [04, 39, 39, 39, 39, 39, 39, 22, 21, 39, 39, 39, 39, 22, 21, 39, 39, 39, 39, 22, 21, 39, 39, 39, 39, 39, 39, 03],
                [06, 12, 12, 12, 12, 19, 39, 22, 33, 14, 14, 19, 00, 22, 21, 00, 20, 14, 14, 34, 21, 39, 20, 12, 12, 12, 12, 05],
                [00, 00, 00, 00, 00, 04, 39, 22, 31, 13, 13, 23, 00, 24, 23, 00, 24, 13, 13, 32, 21, 39, 03, 00, 00, 00, 00, 00],
                [00, 00, 00, 00, 00, 04, 39, 22, 21, 00, 00, 00, 00, 00, 00, 00, 00, 00, 00, 22, 21, 39, 03, 00, 00, 00, 00, 00],
                [00, 00, 00, 00, 00, 04, 39, 22, 21, 00, 26, 12, 30, 37, 37, 29, 12, 25, 00, 22, 21, 39, 03, 00, 00, 00, 00, 00],
                [11, 11, 11, 11, 11, 23, 39, 24, 23, 00, 03, 00, 00, 00, 00, 00, 00, 04, 00, 24, 23, 39, 24, 11, 11, 11, 11, 11],
                [00, 00, 00, 00, 00, 00, 39, 00, 00, 00, 03, 00, 00, 00, 00, 00, 00, 04, 00, 00, 00, 39, 00, 00, 00, 00, 00, 00],
                [12, 12, 12, 12, 12, 19, 39, 20, 19, 00, 03, 00, 00, 00, 00, 00, 00, 04, 00, 20, 19, 39, 20, 12, 12, 12, 12, 12],
                [00, 00, 00, 00, 00, 04, 39, 22, 21, 00, 28, 11, 11, 11, 11, 11, 11, 27, 00, 22, 21, 39, 03, 00, 00, 00, 00, 00],
                [00, 00, 00, 00, 00, 04, 39, 22, 21, 00, 00, 00, 00, 00, 00, 00, 00, 00, 00, 22, 21, 39, 03, 00, 00, 00, 00, 00],
                [00, 00, 00, 00, 00, 04, 39, 22, 21, 00, 20, 14, 14, 14, 14, 14, 14, 19, 00, 22, 21, 39, 03, 00, 00, 00, 00, 00],
                [02, 11, 11, 11, 11, 23, 39, 24, 23, 00, 24, 13, 13, 32, 31, 13, 13, 23, 00, 24, 23, 39, 24, 11, 11, 11, 11, 01],
                [04, 39, 39, 39, 39, 39, 39, 39, 39, 39, 39, 39, 39, 22, 21, 39, 39, 39, 39, 39, 39, 39, 39, 39, 39, 39, 39, 03],
                [04, 39, 20, 14, 14, 19, 39, 20, 14, 14, 14, 19, 39, 22, 21, 39, 20, 14, 14, 14, 19, 39, 20, 14, 14, 19, 39, 03],
                [04, 39, 24, 13, 32, 21, 39, 24, 13, 13, 13, 23, 39, 24, 23, 39, 24, 13, 13, 13, 23, 39, 22, 31, 13, 23, 39, 03],
                [04, 39, 39, 39, 22, 21, 39, 39, 39, 39, 39, 39, 39, 39, 39, 39, 39, 39, 39, 39, 39, 39, 22, 21, 39, 39, 39, 03],
                [08, 14, 19, 39, 22, 21, 39, 20, 19, 39, 20, 14, 14, 14, 14, 14, 14, 19, 39, 20, 19, 39, 22, 21, 39, 20, 14, 07],
                [10, 13, 23, 39, 24, 23, 39, 22, 21, 39, 24, 13, 13, 32, 31, 13, 13, 23, 39, 22, 21, 39, 24, 23, 39, 24, 13, 09],
                [04, 40, 39, 39, 39, 39, 39, 22, 21, 39, 39, 39, 39, 22, 21, 39, 39, 39, 39, 22, 21, 39, 39, 39, 39, 39, 40, 03],
                [04, 39, 20, 14, 14, 14, 14, 23, 24, 14, 14, 19, 39, 22, 21, 39, 20, 14, 14, 23, 24, 14, 14, 14, 14, 19, 39, 03],
                [04, 39, 24, 13, 13, 13, 13, 13, 13, 13, 13, 23, 39, 24, 23, 39, 24, 13, 13, 13, 13, 13, 13, 13, 13, 23, 39, 03],
				[04, 39, 39, 39, 39, 39, 39, 39, 39, 39, 39, 39, 39, 39, 39, 39, 39, 39, 39, 39, 39, 39, 39, 39, 39, 39, 39, 03],
                [06, 12, 12, 12, 12, 12, 12, 12, 12, 12, 12, 12, 12, 12, 12, 12, 12, 12, 12, 12, 12, 12, 12, 12, 12, 12, 12, 05]
            ]
        },
        {
            "id": 1,
            "width": 28,
            "height": 31,
            "super_pac_gum": {
                "duration": 10
            },
            "pac-man": {
                "id": 1,
                "start_pos": {
                    "x": 0,
                    "y": 0
                }
            },
            "ghost": [{
                "id": 1,
                "start_pos": {
                    "x": 0,
                    "y": 0
                }
            }, {
                "id": 2,
                "start_pos": {
                    "x": 0,
                    "y": 0
                }
            }, {
                "id": 3,
                "start_pos": {
                    "x": 0,
                    "y": 0
                }
            }, {
                "id": 4,
                "start_pos": {
                    "x": 0,
                    "y": 0
                }
            }],
            "map": [
                [0, 0, 0, 0, 0, 0, 0, 0, 0, 0, 0, 0, 0, 0, 0, 0, 0, 0, 0, 0, 0, 0, 0, 0, 0, 0, 0, 0],
                [0, 0, 0, 0, 0, 0, 0, 0, 0, 0, 0, 0, 0, 0, 0, 0, 0, 0, 0, 0, 0, 0, 0, 0, 0, 0, 0, 0],
                [0, 0, 0, 0, 0, 0, 0, 0, 0, 0, 0, 0, 0, 0, 0, 0, 0, 0, 0, 0, 0, 0, 0, 0, 0, 0, 0, 0],
                [0, 0, 0, 0, 0, 0, 0, 0, 0, 0, 0, 0, 0, 0, 0, 0, 0, 0, 0, 0, 0, 0, 0, 0, 0, 0, 0, 0],
                [0, 0, 0, 0, 0, 0, 0, 0, 0, 0, 0, 0, 0, 0, 0, 0, 0, 0, 0, 0, 0, 0, 0, 0, 0, 0, 0, 0],
                [0, 0, 0, 0, 0, 0, 0, 0, 0, 0, 0, 0, 0, 0, 0, 0, 0, 0, 0, 0, 0, 0, 0, 0, 0, 0, 0, 0],
                [0, 0, 0, 0, 0, 0, 0, 0, 0, 0, 0, 0, 0, 0, 0, 0, 0, 0, 0, 0, 0, 0, 0, 0, 0, 0, 0, 0],
                [0, 0, 0, 0, 0, 0, 0, 0, 0, 0, 0, 0, 0, 0, 0, 0, 0, 0, 0, 0, 0, 0, 0, 0, 0, 0, 0, 0],
                [0, 0, 0, 0, 0, 0, 0, 0, 0, 0, 0, 0, 0, 0, 0, 0, 0, 0, 0, 0, 0, 0, 0, 0, 0, 0, 0, 0],
                [0, 0, 0, 0, 0, 0, 0, 0, 0, 0, 0, 0, 0, 0, 0, 0, 0, 0, 0, 0, 0, 0, 0, 0, 0, 0, 0, 0],
                [0, 0, 0, 0, 0, 0, 0, 0, 0, 0, 0, 0, 0, 0, 0, 0, 0, 0, 0, 0, 0, 0, 0, 0, 0, 0, 0, 0],
                [0, 0, 0, 0, 0, 0, 0, 0, 0, 0, 0, 0, 0, 0, 0, 0, 0, 0, 0, 0, 0, 0, 0, 0, 0, 0, 0, 0],
                [0, 0, 0, 0, 0, 0, 0, 0, 0, 0, 0, 0, 0, 0, 0, 0, 0, 0, 0, 0, 0, 0, 0, 0, 0, 0, 0, 0],
                [0, 0, 0, 0, 0, 0, 0, 0, 0, 0, 0, 0, 0, 0, 0, 0, 0, 0, 0, 0, 0, 0, 0, 0, 0, 0, 0, 0],
                [0, 0, 0, 0, 0, 0, 0, 0, 0, 0, 0, 0, 0, 0, 0, 0, 0, 0, 0, 0, 0, 0, 0, 0, 0, 0, 0, 0],
                [0, 0, 0, 0, 0, 0, 0, 0, 0, 0, 0, 0, 0, 0, 0, 0, 0, 0, 0, 0, 0, 0, 0, 0, 0, 0, 0, 0],
                [0, 0, 0, 0, 0, 0, 0, 0, 0, 0, 0, 0, 0, 0, 0, 0, 0, 0, 0, 0, 0, 0, 0, 0, 0, 0, 0, 0],
                [0, 0, 0, 0, 0, 0, 0, 0, 0, 0, 0, 0, 0, 0, 0, 0, 0, 0, 0, 0, 0, 0, 0, 0, 0, 0, 0, 0],
                [0, 0, 0, 0, 0, 0, 0, 0, 0, 0, 0, 0, 0, 0, 0, 0, 0, 0, 0, 0, 0, 0, 0, 0, 0, 0, 0, 0],
                [0, 0, 0, 0, 0, 0, 0, 0, 0, 0, 0, 0, 0, 0, 0, 0, 0, 0, 0, 0, 0, 0, 0, 0, 0, 0, 0, 0],
                [0, 0, 0, 0, 0, 0, 0, 0, 0, 0, 0, 0, 0, 0, 0, 0, 0, 0, 0, 0, 0, 0, 0, 0, 0, 0, 0, 0],
                [0, 0, 0, 0, 0, 0, 0, 0, 0, 0, 0, 0, 0, 0, 0, 0, 0, 0, 0, 0, 0, 0, 0, 0, 0, 0, 0, 0],
                [0, 0, 0, 0, 0, 0, 0, 0, 0, 0, 0, 0, 0, 0, 0, 0, 0, 0, 0, 0, 0, 0, 0, 0, 0, 0, 0, 0],
                [0, 0, 0, 0, 0, 0, 0, 0, 0, 0, 0, 0, 0, 0, 0, 0, 0, 0, 0, 0, 0, 0, 0, 0, 0, 0, 0, 0],
                [0, 0, 0, 0, 0, 0, 0, 0, 0, 0, 0, 0, 0, 0, 0, 0, 0, 0, 0, 0, 0, 0, 0, 0, 0, 0, 0, 0],
                [0, 0, 0, 0, 0, 0, 0, 0, 0, 0, 0, 0, 0, 0, 0, 0, 0, 0, 0, 0, 0, 0, 0, 0, 0, 0, 0, 0],
                [0, 0, 0, 0, 0, 0, 0, 0, 0, 0, 0, 0, 0, 0, 0, 0, 0, 0, 0, 0, 0, 0, 0, 0, 0, 0, 0, 0],
                [0, 0, 0, 0, 0, 0, 0, 0, 0, 0, 0, 0, 0, 0, 0, 0, 0, 0, 0, 0, 0, 0, 0, 0, 0, 0, 0, 0],
                [0, 0, 0, 0, 0, 0, 0, 0, 0, 0, 0, 0, 0, 0, 0, 0, 0, 0, 0, 0, 0, 0, 0, 0, 0, 0, 0, 0],
                [0, 0, 0, 0, 0, 0, 0, 0, 0, 0, 0, 0, 0, 0, 0, 0, 0, 0, 0, 0, 0, 0, 0, 0, 0, 0, 0, 0],
                [0, 0, 0, 0, 0, 0, 0, 0, 0, 0, 0, 0, 0, 0, 0, 0, 0, 0, 0, 0, 0, 0, 0, 0, 0, 0, 0, 0]
            ]
        },
        {
            "id": 2,
            "width": 28,
            "height": 31,
            "super_pac_gum": {
                "duration": 10
            },
            "pac-man": {
                "id": 1,
                "start_pos": {
                    "x": 0,
                    "y": 0
                }
            },
            "ghost": [{
                "id": 1,
                "start_pos": {
                    "x": 0,
                    "y": 0
                }
            }, {
                "id": 2,
                "start_pos": {
                    "x": 0,
                    "y": 0
                }
            }, {
                "id": 3,
                "start_pos": {
                    "x": 0,
                    "y": 0
                }
            }, {
                "id": 4,
                "start_pos": {
                    "x": 0,
                    "y": 0
                }
            }],
            "map": [
                [0, 0, 0, 0, 0, 0, 0, 0, 0, 0, 0, 0, 0, 0, 0, 0, 0, 0, 0, 0, 0, 0, 0, 0, 0, 0, 0, 0],
                [0, 0, 0, 0, 0, 0, 0, 0, 0, 0, 0, 0, 0, 0, 0, 0, 0, 0, 0, 0, 0, 0, 0, 0, 0, 0, 0, 0],
                [0, 0, 0, 0, 0, 0, 0, 0, 0, 0, 0, 0, 0, 0, 0, 0, 0, 0, 0, 0, 0, 0, 0, 0, 0, 0, 0, 0],
                [0, 0, 0, 0, 0, 0, 0, 0, 0, 0, 0, 0, 0, 0, 0, 0, 0, 0, 0, 0, 0, 0, 0, 0, 0, 0, 0, 0],
                [0, 0, 0, 0, 0, 0, 0, 0, 0, 0, 0, 0, 0, 0, 0, 0, 0, 0, 0, 0, 0, 0, 0, 0, 0, 0, 0, 0],
                [0, 0, 0, 0, 0, 0, 0, 0, 0, 0, 0, 0, 0, 0, 0, 0, 0, 0, 0, 0, 0, 0, 0, 0, 0, 0, 0, 0],
                [0, 0, 0, 0, 0, 0, 0, 0, 0, 0, 0, 0, 0, 0, 0, 0, 0, 0, 0, 0, 0, 0, 0, 0, 0, 0, 0, 0],
                [0, 0, 0, 0, 0, 0, 0, 0, 0, 0, 0, 0, 0, 0, 0, 0, 0, 0, 0, 0, 0, 0, 0, 0, 0, 0, 0, 0],
                [0, 0, 0, 0, 0, 0, 0, 0, 0, 0, 0, 0, 0, 0, 0, 0, 0, 0, 0, 0, 0, 0, 0, 0, 0, 0, 0, 0],
                [0, 0, 0, 0, 0, 0, 0, 0, 0, 0, 0, 0, 0, 0, 0, 0, 0, 0, 0, 0, 0, 0, 0, 0, 0, 0, 0, 0],
                [0, 0, 0, 0, 0, 0, 0, 0, 0, 0, 0, 0, 0, 0, 0, 0, 0, 0, 0, 0, 0, 0, 0, 0, 0, 0, 0, 0],
                [0, 0, 0, 0, 0, 0, 0, 0, 0, 0, 0, 0, 0, 0, 0, 0, 0, 0, 0, 0, 0, 0, 0, 0, 0, 0, 0, 0],
                [0, 0, 0, 0, 0, 0, 0, 0, 0, 0, 0, 0, 0, 0, 0, 0, 0, 0, 0, 0, 0, 0, 0, 0, 0, 0, 0, 0],
                [0, 0, 0, 0, 0, 0, 0, 0, 0, 0, 0, 0, 0, 0, 0, 0, 0, 0, 0, 0, 0, 0, 0, 0, 0, 0, 0, 0],
                [0, 0, 0, 0, 0, 0, 0, 0, 0, 0, 0, 0, 0, 0, 0, 0, 0, 0, 0, 0, 0, 0, 0, 0, 0, 0, 0, 0],
                [0, 0, 0, 0, 0, 0, 0, 0, 0, 0, 0, 0, 0, 0, 0, 0, 0, 0, 0, 0, 0, 0, 0, 0, 0, 0, 0, 0],
                [0, 0, 0, 0, 0, 0, 0, 0, 0, 0, 0, 0, 0, 0, 0, 0, 0, 0, 0, 0, 0, 0, 0, 0, 0, 0, 0, 0],
                [0, 0, 0, 0, 0, 0, 0, 0, 0, 0, 0, 0, 0, 0, 0, 0, 0, 0, 0, 0, 0, 0, 0, 0, 0, 0, 0, 0],
                [0, 0, 0, 0, 0, 0, 0, 0, 0, 0, 0, 0, 0, 0, 0, 0, 0, 0, 0, 0, 0, 0, 0, 0, 0, 0, 0, 0],
                [0, 0, 0, 0, 0, 0, 0, 0, 0, 0, 0, 0, 0, 0, 0, 0, 0, 0, 0, 0, 0, 0, 0, 0, 0, 0, 0, 0],
                [0, 0, 0, 0, 0, 0, 0, 0, 0, 0, 0, 0, 0, 0, 0, 0, 0, 0, 0, 0, 0, 0, 0, 0, 0, 0, 0, 0],
                [0, 0, 0, 0, 0, 0, 0, 0, 0, 0, 0, 0, 0, 0, 0, 0, 0, 0, 0, 0, 0, 0, 0, 0, 0, 0, 0, 0],
                [0, 0, 0, 0, 0, 0, 0, 0, 0, 0, 0, 0, 0, 0, 0, 0, 0, 0, 0, 0, 0, 0, 0, 0, 0, 0, 0, 0],
                [0, 0, 0, 0, 0, 0, 0, 0, 0, 0, 0, 0, 0, 0, 0, 0, 0, 0, 0, 0, 0, 0, 0, 0, 0, 0, 0, 0],
                [0, 0, 0, 0, 0, 0, 0, 0, 0, 0, 0, 0, 0, 0, 0, 0, 0, 0, 0, 0, 0, 0, 0, 0, 0, 0, 0, 0],
                [0, 0, 0, 0, 0, 0, 0, 0, 0, 0, 0, 0, 0, 0, 0, 0, 0, 0, 0, 0, 0, 0, 0, 0, 0, 0, 0, 0],
                [0, 0, 0, 0, 0, 0, 0, 0, 0, 0, 0, 0, 0, 0, 0, 0, 0, 0, 0, 0, 0, 0, 0, 0, 0, 0, 0, 0],
                [0, 0, 0, 0, 0, 0, 0, 0, 0, 0, 0, 0, 0, 0, 0, 0, 0, 0, 0, 0, 0, 0, 0, 0, 0, 0, 0, 0],
                [0, 0, 0, 0, 0, 0, 0, 0, 0, 0, 0, 0, 0, 0, 0, 0, 0, 0, 0, 0, 0, 0, 0, 0, 0, 0, 0, 0],
                [0, 0, 0, 0, 0, 0, 0, 0, 0, 0, 0, 0, 0, 0, 0, 0, 0, 0, 0, 0, 0, 0, 0, 0, 0, 0, 0, 0],
                [0, 0, 0, 0, 0, 0, 0, 0, 0, 0, 0, 0, 0, 0, 0, 0, 0, 0, 0, 0, 0, 0, 0, 0, 0, 0, 0, 0]
            ]
        }
    ]
}
