{
    "current_level": 0,
    "levels": [{
            "id": 0,
            "width": 28,
            "height": 31,
            "super_pac_gum": {
                "duration": 10
            },
            "pac-man": {
                "id": 1,
                "start_pos": {
                    "x": 13,
                    "y": 23
                }
            },
            "ghost": [{
                "id": 1,
                "speed": 1,
                "start_pos": {
                    "x": 0,
                    "y": 0
                }
            }, {
                "id": 2,
                "speed": 1,
                "start_pos": {
                    "x": 0,
                    "y": 0
                }
            }, {
                "id": 3,
                "speed": 1,
                "start_pos": {
                    "x": 0,
                    "y": 0
                }
            }, {
                "id": 4,
                "speed": 1,
                "start_pos": {
                    "x": 0,
                    "y": 0
                }
            }],
            "map": [
				[02, 13, 13, 13, 13, 13, 13, 13, 13, 13, 13, 13, 13, 40, 39, 13, 13, 13, 13, 13, 13, 13, 13, 13, 13, 13, 13, 01],
                [04, 42, 42, 42, 42, 42, 42, 42, 42, 42, 42, 42, 42, 26, 25, 42, 42, 42, 42, 42, 42, 42, 42, 42, 42, 42, 42, 03],
                [04, 42, 24, 16, 16, 23, 42, 24, 16, 16, 16, 23, 42, 26, 25, 42, 24, 16, 16, 16, 23, 42, 24, 16, 16, 23, 42, 03],
                [04, 43, 26, 00, 00, 25, 42, 26, 00, 00, 00, 25, 42, 26, 25, 42, 26, 00, 00, 00, 25, 42, 26, 00, 00, 25, 43, 03],
                [04, 42, 28, 11, 11, 27, 42, 28, 11, 11, 11, 27, 42, 28, 27, 42, 28, 11, 11, 11, 27, 42, 28, 11, 11, 27, 42, 03],
                [04, 42, 42, 42, 42, 42, 42, 42, 42, 42, 42, 42, 42, 42, 42, 42, 42, 42, 42, 42, 42, 42, 42, 42, 42, 42, 42, 03],
                [04, 42, 24, 16, 16, 23, 42, 24, 23, 42, 24, 16, 16, 16, 16, 16, 16, 23, 42, 24, 23, 42, 24, 16, 16, 23, 42, 03],
                [04, 42, 28, 11, 11, 27, 42, 26, 25, 42, 28, 11, 11, 36, 35, 11, 11, 27, 42, 26, 25, 42, 28, 11, 11, 27, 42, 03],
                [04, 42, 42, 42, 42, 42, 42, 26, 25, 42, 42, 42, 42, 26, 25, 42, 42, 42, 42, 26, 25, 42, 42, 42, 42, 42, 42, 03],
                [06, 14, 14, 14, 14, 23, 42, 26, 37, 16, 16, 23, 00, 26, 25, 00, 24, 16, 16, 38, 25, 42, 24, 14, 14, 14, 14, 05],
                [00, 00, 00, 00, 00, 04, 42, 26, 35, 11, 11, 27, 00, 28, 27, 00, 28, 11, 11, 36, 25, 42, 03, 00, 00, 00, 00, 00],
                [00, 00, 00, 00, 00, 04, 42, 26, 25, 00, 00, 00, 00, 00, 00, 00, 00, 00, 00, 26, 25, 42, 03, 00, 00, 00, 00, 00],
                [00, 00, 00, 00, 00, 04, 42, 26, 25, 00, 30, 14, 34, 41, 41, 33, 14, 29, 00, 26, 25, 42, 03, 00, 00, 00, 00, 00],
                [13, 13, 13, 13, 13, 27, 42, 28, 27, 00, 03, 00, 00, 00, 00, 00, 00, 04, 00, 28, 27, 42, 28, 13, 13, 13, 13, 13],
                [00, 00, 00, 00, 00, 00, 42, 00, 00, 00, 03, 00, 00, 00, 00, 00, 00, 04, 00, 00, 00, 42, 00, 00, 00, 00, 00, 00],
                [14, 14, 14, 14, 14, 23, 42, 24, 23, 00, 03, 00, 00, 00, 00, 00, 00, 04, 00, 24, 23, 42, 24, 14, 14, 14, 14, 14],
                [00, 00, 00, 00, 00, 04, 42, 26, 25, 00, 32, 13, 13, 13, 13, 13, 13, 31, 00, 26, 25, 42, 03, 00, 00, 00, 00, 00],
                [00, 00, 00, 00, 00, 04, 42, 26, 25, 00, 00, 00, 00, 00, 00, 00, 00, 00, 00, 26, 25, 42, 03, 00, 00, 00, 00, 00],
                [00, 00, 00, 00, 00, 04, 42, 26, 25, 00, 24, 16, 16, 16, 16, 16, 16, 23, 00, 26, 25, 42, 03, 00, 00, 00, 00, 00],
                [02, 13, 13, 13, 13, 27, 42, 28, 27, 00, 28, 11, 11, 36, 35, 11, 11, 27, 00, 28, 27, 42, 28, 13, 13, 13, 13, 01],
                [04, 42, 42, 42, 42, 42, 42, 42, 42, 42, 42, 42, 42, 26, 25, 42, 42, 42, 42, 42, 42, 42, 42, 42, 42, 42, 42, 03],
                [04, 42, 24, 16, 16, 23, 42, 24, 16, 16, 16, 23, 42, 26, 25, 42, 24, 16, 16, 16, 23, 42, 24, 16, 16, 23, 42, 03],
                [04, 42, 28, 11, 36, 25, 42, 28, 11, 11, 11, 27, 42, 28, 27, 42, 28, 11, 11, 11, 27, 42, 26, 35, 11, 27, 42, 03],
                [04, 43, 42, 42, 26, 25, 42, 42, 42, 42, 42, 42, 42, 42, 42, 42, 42, 42, 42, 42, 42, 42, 26, 25, 42, 42, 43, 03],
                [08, 16, 23, 42, 26, 25, 42, 24, 23, 42, 24, 16, 16, 16, 16, 16, 16, 23, 42, 24, 23, 42, 26, 25, 42, 24, 16, 07],
                [10, 15, 27, 42, 28, 27, 42, 26, 25, 42, 28, 11, 11, 36, 35, 11, 11, 27, 42, 26, 25, 42, 28, 27, 42, 28, 15, 09],
                [04, 42, 42, 42, 42, 42, 42, 26, 25, 42, 42, 42, 42, 26, 25, 42, 42, 42, 42, 26, 25, 42, 42, 42, 42, 42, 42, 03],
                [04, 42, 24, 16, 16, 16, 16, 27, 28, 16, 16, 23, 42, 26, 25, 42, 24, 16, 16, 27, 28, 16, 16, 16, 16, 23, 42, 03],
                [04, 42, 28, 11, 11, 11, 11, 11, 11, 11, 11, 27, 42, 28, 27, 42, 28, 11, 11, 11, 11, 11, 11, 11, 11, 27, 42, 03],
				[04, 42, 42, 42, 42, 42, 42, 42, 42, 42, 42, 42, 42, 42, 42, 42, 42, 42, 42, 42, 42, 42, 42, 42, 42, 42, 42, 03],
                [06, 14, 14, 14, 14, 14, 14, 14, 14, 14, 14, 14, 14, 14, 14, 14, 14, 14, 14, 14, 14, 14, 14, 14, 14, 14, 14, 05]
            ]
        },
        {
            "id": 1,
            "width": 28,
            "height": 31,
            "super_pac_gum": {
                "duration": 10
            },
            "pac-man": {
                "id": 1,
                "start_pos": {
                    "x": 0,
                    "y": 0
                }
            },
            "ghost": [{
                "id": 1,
                "start_pos": {
                    "x": 0,
                    "y": 0
                }
            }, {
                "id": 2,
                "start_pos": {
                    "x": 0,
                    "y": 0
                }
            }, {
                "id": 3,
                "start_pos": {
                    "x": 0,
                    "y": 0
                }
            }, {
                "id": 4,
                "start_pos": {
                    "x": 0,
                    "y": 0
                }
            }],
            "map": [
                [0, 0, 0, 0, 0, 0, 0, 0, 0, 0, 0, 0, 0, 0, 0, 0, 0, 0, 0, 0, 0, 0, 0, 0, 0, 0, 0, 0],
                [0, 0, 0, 0, 0, 0, 0, 0, 0, 0, 0, 0, 0, 0, 0, 0, 0, 0, 0, 0, 0, 0, 0, 0, 0, 0, 0, 0],
                [0, 0, 0, 0, 0, 0, 0, 0, 0, 0, 0, 0, 0, 0, 0, 0, 0, 0, 0, 0, 0, 0, 0, 0, 0, 0, 0, 0],
                [0, 0, 0, 0, 0, 0, 0, 0, 0, 0, 0, 0, 0, 0, 0, 0, 0, 0, 0, 0, 0, 0, 0, 0, 0, 0, 0, 0],
                [0, 0, 0, 0, 0, 0, 0, 0, 0, 0, 0, 0, 0, 0, 0, 0, 0, 0, 0, 0, 0, 0, 0, 0, 0, 0, 0, 0],
                [0, 0, 0, 0, 0, 0, 0, 0, 0, 0, 0, 0, 0, 0, 0, 0, 0, 0, 0, 0, 0, 0, 0, 0, 0, 0, 0, 0],
                [0, 0, 0, 0, 0, 0, 0, 0, 0, 0, 0, 0, 0, 0, 0, 0, 0, 0, 0, 0, 0, 0, 0, 0, 0, 0, 0, 0],
                [0, 0, 0, 0, 0, 0, 0, 0, 0, 0, 0, 0, 0, 0, 0, 0, 0, 0, 0, 0, 0, 0, 0, 0, 0, 0, 0, 0],
                [0, 0, 0, 0, 0, 0, 0, 0, 0, 0, 0, 0, 0, 0, 0, 0, 0, 0, 0, 0, 0, 0, 0, 0, 0, 0, 0, 0],
                [0, 0, 0, 0, 0, 0, 0, 0, 0, 0, 0, 0, 0, 0, 0, 0, 0, 0, 0, 0, 0, 0, 0, 0, 0, 0, 0, 0],
                [0, 0, 0, 0, 0, 0, 0, 0, 0, 0, 0, 0, 0, 0, 0, 0, 0, 0, 0, 0, 0, 0, 0, 0, 0, 0, 0, 0],
                [0, 0, 0, 0, 0, 0, 0, 0, 0, 0, 0, 0, 0, 0, 0, 0, 0, 0, 0, 0, 0, 0, 0, 0, 0, 0, 0, 0],
                [0, 0, 0, 0, 0, 0, 0, 0, 0, 0, 0, 0, 0, 0, 0, 0, 0, 0, 0, 0, 0, 0, 0, 0, 0, 0, 0, 0],
                [0, 0, 0, 0, 0, 0, 0, 0, 0, 0, 0, 0, 0, 0, 0, 0, 0, 0, 0, 0, 0, 0, 0, 0, 0, 0, 0, 0],
                [0, 0, 0, 0, 0, 0, 0, 0, 0, 0, 0, 0, 0, 0, 0, 0, 0, 0, 0, 0, 0, 0, 0, 0, 0, 0, 0, 0],
                [0, 0, 0, 0, 0, 0, 0, 0, 0, 0, 0, 0, 0, 0, 0, 0, 0, 0, 0, 0, 0, 0, 0, 0, 0, 0, 0, 0],
                [0, 0, 0, 0, 0, 0, 0, 0, 0, 0, 0, 0, 0, 0, 0, 0, 0, 0, 0, 0, 0, 0, 0, 0, 0, 0, 0, 0],
                [0, 0, 0, 0, 0, 0, 0, 0, 0, 0, 0, 0, 0, 0, 0, 0, 0, 0, 0, 0, 0, 0, 0, 0, 0, 0, 0, 0],
                [0, 0, 0, 0, 0, 0, 0, 0, 0, 0, 0, 0, 0, 0, 0, 0, 0, 0, 0, 0, 0, 0, 0, 0, 0, 0, 0, 0],
                [0, 0, 0, 0, 0, 0, 0, 0, 0, 0, 0, 0, 0, 0, 0, 0, 0, 0, 0, 0, 0, 0, 0, 0, 0, 0, 0, 0],
                [0, 0, 0, 0, 0, 0, 0, 0, 0, 0, 0, 0, 0, 0, 0, 0, 0, 0, 0, 0, 0, 0, 0, 0, 0, 0, 0, 0],
                [0, 0, 0, 0, 0, 0, 0, 0, 0, 0, 0, 0, 0, 0, 0, 0, 0, 0, 0, 0, 0, 0, 0, 0, 0, 0, 0, 0],
                [0, 0, 0, 0, 0, 0, 0, 0, 0, 0, 0, 0, 0, 0, 0, 0, 0, 0, 0, 0, 0, 0, 0, 0, 0, 0, 0, 0],
                [0, 0, 0, 0, 0, 0, 0, 0, 0, 0, 0, 0, 0, 0, 0, 0, 0, 0, 0, 0, 0, 0, 0, 0, 0, 0, 0, 0],
                [0, 0, 0, 0, 0, 0, 0, 0, 0, 0, 0, 0, 0, 0, 0, 0, 0, 0, 0, 0, 0, 0, 0, 0, 0, 0, 0, 0],
                [0, 0, 0, 0, 0, 0, 0, 0, 0, 0, 0, 0, 0, 0, 0, 0, 0, 0, 0, 0, 0, 0, 0, 0, 0, 0, 0, 0],
                [0, 0, 0, 0, 0, 0, 0, 0, 0, 0, 0, 0, 0, 0, 0, 0, 0, 0, 0, 0, 0, 0, 0, 0, 0, 0, 0, 0],
                [0, 0, 0, 0, 0, 0, 0, 0, 0, 0, 0, 0, 0, 0, 0, 0, 0, 0, 0, 0, 0, 0, 0, 0, 0, 0, 0, 0],
                [0, 0, 0, 0, 0, 0, 0, 0, 0, 0, 0, 0, 0, 0, 0, 0, 0, 0, 0, 0, 0, 0, 0, 0, 0, 0, 0, 0],
                [0, 0, 0, 0, 0, 0, 0, 0, 0, 0, 0, 0, 0, 0, 0, 0, 0, 0, 0, 0, 0, 0, 0, 0, 0, 0, 0, 0],
                [0, 0, 0, 0, 0, 0, 0, 0, 0, 0, 0, 0, 0, 0, 0, 0, 0, 0, 0, 0, 0, 0, 0, 0, 0, 0, 0, 0]
            ]
        },
        {
            "id": 2,
            "width": 28,
            "height": 31,
            "super_pac_gum": {
                "duration": 10
            },
            "pac-man": {
                "id": 1,
                "start_pos": {
                    "x": 0,
                    "y": 0
                }
            },
            "ghost": [{
                "id": 1,
                "start_pos": {
                    "x": 0,
                    "y": 0
                }
            }, {
                "id": 2,
                "start_pos": {
                    "x": 0,
                    "y": 0
                }
            }, {
                "id": 3,
                "start_pos": {
                    "x": 0,
                    "y": 0
                }
            }, {
                "id": 4,
                "start_pos": {
                    "x": 0,
                    "y": 0
                }
            }],
            "map": [
                [0, 0, 0, 0, 0, 0, 0, 0, 0, 0, 0, 0, 0, 0, 0, 0, 0, 0, 0, 0, 0, 0, 0, 0, 0, 0, 0, 0],
                [0, 0, 0, 0, 0, 0, 0, 0, 0, 0, 0, 0, 0, 0, 0, 0, 0, 0, 0, 0, 0, 0, 0, 0, 0, 0, 0, 0],
                [0, 0, 0, 0, 0, 0, 0, 0, 0, 0, 0, 0, 0, 0, 0, 0, 0, 0, 0, 0, 0, 0, 0, 0, 0, 0, 0, 0],
                [0, 0, 0, 0, 0, 0, 0, 0, 0, 0, 0, 0, 0, 0, 0, 0, 0, 0, 0, 0, 0, 0, 0, 0, 0, 0, 0, 0],
                [0, 0, 0, 0, 0, 0, 0, 0, 0, 0, 0, 0, 0, 0, 0, 0, 0, 0, 0, 0, 0, 0, 0, 0, 0, 0, 0, 0],
                [0, 0, 0, 0, 0, 0, 0, 0, 0, 0, 0, 0, 0, 0, 0, 0, 0, 0, 0, 0, 0, 0, 0, 0, 0, 0, 0, 0],
                [0, 0, 0, 0, 0, 0, 0, 0, 0, 0, 0, 0, 0, 0, 0, 0, 0, 0, 0, 0, 0, 0, 0, 0, 0, 0, 0, 0],
                [0, 0, 0, 0, 0, 0, 0, 0, 0, 0, 0, 0, 0, 0, 0, 0, 0, 0, 0, 0, 0, 0, 0, 0, 0, 0, 0, 0],
                [0, 0, 0, 0, 0, 0, 0, 0, 0, 0, 0, 0, 0, 0, 0, 0, 0, 0, 0, 0, 0, 0, 0, 0, 0, 0, 0, 0],
                [0, 0, 0, 0, 0, 0, 0, 0, 0, 0, 0, 0, 0, 0, 0, 0, 0, 0, 0, 0, 0, 0, 0, 0, 0, 0, 0, 0],
                [0, 0, 0, 0, 0, 0, 0, 0, 0, 0, 0, 0, 0, 0, 0, 0, 0, 0, 0, 0, 0, 0, 0, 0, 0, 0, 0, 0],
                [0, 0, 0, 0, 0, 0, 0, 0, 0, 0, 0, 0, 0, 0, 0, 0, 0, 0, 0, 0, 0, 0, 0, 0, 0, 0, 0, 0],
                [0, 0, 0, 0, 0, 0, 0, 0, 0, 0, 0, 0, 0, 0, 0, 0, 0, 0, 0, 0, 0, 0, 0, 0, 0, 0, 0, 0],
                [0, 0, 0, 0, 0, 0, 0, 0, 0, 0, 0, 0, 0, 0, 0, 0, 0, 0, 0, 0, 0, 0, 0, 0, 0, 0, 0, 0],
                [0, 0, 0, 0, 0, 0, 0, 0, 0, 0, 0, 0, 0, 0, 0, 0, 0, 0, 0, 0, 0, 0, 0, 0, 0, 0, 0, 0],
                [0, 0, 0, 0, 0, 0, 0, 0, 0, 0, 0, 0, 0, 0, 0, 0, 0, 0, 0, 0, 0, 0, 0, 0, 0, 0, 0, 0],
                [0, 0, 0, 0, 0, 0, 0, 0, 0, 0, 0, 0, 0, 0, 0, 0, 0, 0, 0, 0, 0, 0, 0, 0, 0, 0, 0, 0],
                [0, 0, 0, 0, 0, 0, 0, 0, 0, 0, 0, 0, 0, 0, 0, 0, 0, 0, 0, 0, 0, 0, 0, 0, 0, 0, 0, 0],
                [0, 0, 0, 0, 0, 0, 0, 0, 0, 0, 0, 0, 0, 0, 0, 0, 0, 0, 0, 0, 0, 0, 0, 0, 0, 0, 0, 0],
                [0, 0, 0, 0, 0, 0, 0, 0, 0, 0, 0, 0, 0, 0, 0, 0, 0, 0, 0, 0, 0, 0, 0, 0, 0, 0, 0, 0],
                [0, 0, 0, 0, 0, 0, 0, 0, 0, 0, 0, 0, 0, 0, 0, 0, 0, 0, 0, 0, 0, 0, 0, 0, 0, 0, 0, 0],
                [0, 0, 0, 0, 0, 0, 0, 0, 0, 0, 0, 0, 0, 0, 0, 0, 0, 0, 0, 0, 0, 0, 0, 0, 0, 0, 0, 0],
                [0, 0, 0, 0, 0, 0, 0, 0, 0, 0, 0, 0, 0, 0, 0, 0, 0, 0, 0, 0, 0, 0, 0, 0, 0, 0, 0, 0],
                [0, 0, 0, 0, 0, 0, 0, 0, 0, 0, 0, 0, 0, 0, 0, 0, 0, 0, 0, 0, 0, 0, 0, 0, 0, 0, 0, 0],
                [0, 0, 0, 0, 0, 0, 0, 0, 0, 0, 0, 0, 0, 0, 0, 0, 0, 0, 0, 0, 0, 0, 0, 0, 0, 0, 0, 0],
                [0, 0, 0, 0, 0, 0, 0, 0, 0, 0, 0, 0, 0, 0, 0, 0, 0, 0, 0, 0, 0, 0, 0, 0, 0, 0, 0, 0],
                [0, 0, 0, 0, 0, 0, 0, 0, 0, 0, 0, 0, 0, 0, 0, 0, 0, 0, 0, 0, 0, 0, 0, 0, 0, 0, 0, 0],
                [0, 0, 0, 0, 0, 0, 0, 0, 0, 0, 0, 0, 0, 0, 0, 0, 0, 0, 0, 0, 0, 0, 0, 0, 0, 0, 0, 0],
                [0, 0, 0, 0, 0, 0, 0, 0, 0, 0, 0, 0, 0, 0, 0, 0, 0, 0, 0, 0, 0, 0, 0, 0, 0, 0, 0, 0],
                [0, 0, 0, 0, 0, 0, 0, 0, 0, 0, 0, 0, 0, 0, 0, 0, 0, 0, 0, 0, 0, 0, 0, 0, 0, 0, 0, 0],
                [0, 0, 0, 0, 0, 0, 0, 0, 0, 0, 0, 0, 0, 0, 0, 0, 0, 0, 0, 0, 0, 0, 0, 0, 0, 0, 0, 0]
            ]
        }
    ]
}
