{
    "current_level": 0,
    "levels": [{
            "id": 0,
            "width": 28,
            "height": 31,
            "super_pac_gum": {
                "duration": 10
            },
            "pac-man": {
                "id": 1,
                "start_pos": {
                    "x": 13,
                    "y": 23
                }
            },
            "ghost": [{
                "id": 1,
                "speed": 1,
                "start_pos": {
                    "x": 0,
                    "y": 0
                }
            }, {
                "id": 2,
                "speed": 1,
                "start_pos": {
                    "x": 0,
                    "y": 0
                }
            }, {
                "id": 3,
                "speed": 1,
                "start_pos": {
                    "x": 0,
                    "y": 0
                }
            }, {
                "id": 4,
                "speed": 1,
                "start_pos": {
                    "x": 0,
                    "y": 0
                }
            }],
            "map": [
				[02, 13, 13, 13, 13, 13, 13, 13, 13, 13, 13, 13, 13, 35, 39, 13, 13, 13, 13, 13, 13, 13, 13, 13, 13, 13, 13, 01],
                [04, 42, 42, 42, 42, 42, 42, 42, 42, 42, 42, 42, 42, 22, 21, 42, 42, 42, 42, 42, 42, 42, 42, 42, 42, 42, 42, 03],
                [04, 42, 20, 14, 14, 19, 42, 20, 14, 14, 14, 19, 42, 22, 21, 42, 20, 14, 14, 14, 19, 42, 20, 14, 14, 19, 42, 03],
                [04, 43, 22, 00, 00, 21, 42, 22, 00, 00, 00, 21, 42, 22, 21, 42, 22, 00, 00, 00, 21, 42, 22, 00, 00, 21, 43, 03],
                [04, 42, 24, 13, 13, 23, 42, 24, 13, 13, 13, 23, 42, 24, 23, 42, 24, 13, 13, 13, 23, 42, 24, 13, 13, 23, 42, 03],
                [04, 42, 42, 42, 42, 42, 42, 42, 42, 42, 42, 42, 42, 42, 42, 42, 42, 42, 42, 42, 42, 42, 42, 42, 42, 42, 42, 03],
                [04, 42, 20, 14, 14, 19, 42, 20, 19, 42, 20, 14, 14, 14, 14, 14, 14, 19, 42, 20, 19, 42, 20, 14, 14, 19, 42, 03],
                [04, 42, 24, 13, 13, 23, 42, 22, 21, 42, 24, 13, 13, 32, 31, 13, 13, 23, 42, 22, 21, 42, 24, 13, 13, 23, 42, 03],
                [04, 42, 42, 42, 42, 42, 42, 22, 21, 42, 42, 42, 42, 22, 21, 42, 42, 42, 42, 22, 21, 42, 42, 42, 42, 42, 42, 03],
                [06, 13, 13, 13, 13, 19, 42, 22, 33, 14, 14, 19, 00, 22, 21, 00, 20, 14, 14, 34, 21, 42, 20, 13, 13, 13, 13, 05],
                [00, 00, 00, 00, 00, 04, 42, 22, 31, 13, 13, 23, 00, 24, 23, 00, 24, 13, 13, 32, 21, 42, 03, 00, 00, 00, 00, 00],
                [00, 00, 00, 00, 00, 04, 42, 22, 21, 00, 00, 00, 00, 00, 00, 00, 00, 00, 00, 22, 21, 42, 03, 00, 00, 00, 00, 00],
                [00, 00, 00, 00, 00, 04, 42, 22, 21, 00, 26, 13, 30, 36, 36, 29, 13, 25, 00, 22, 21, 42, 03, 00, 00, 00, 00, 00],
                [13, 13, 13, 13, 13, 23, 42, 24, 23, 00, 03, 00, 00, 00, 00, 00, 00, 04, 00, 24, 23, 42, 24, 13, 13, 13, 13, 13],
                [00, 00, 00, 00, 00, 00, 42, 00, 00, 00, 03, 00, 00, 00, 00, 00, 00, 04, 00, 00, 00, 42, 00, 00, 00, 00, 00, 00],
                [13, 13, 13, 13, 13, 19, 42, 20, 19, 00, 03, 00, 00, 00, 00, 00, 00, 04, 00, 20, 19, 42, 20, 13, 13, 13, 13, 13],
                [00, 00, 00, 00, 00, 04, 42, 22, 21, 00, 28, 13, 13, 13, 13, 13, 13, 27, 00, 22, 21, 42, 03, 00, 00, 00, 00, 00],
                [00, 00, 00, 00, 00, 04, 42, 22, 21, 00, 00, 00, 00, 00, 00, 00, 00, 00, 00, 22, 21, 42, 03, 00, 00, 00, 00, 00],
                [00, 00, 00, 00, 00, 04, 42, 22, 21, 00, 20, 14, 14, 14, 14, 14, 14, 19, 00, 22, 21, 42, 03, 00, 00, 00, 00, 00],
                [02, 13, 13, 13, 13, 23, 42, 24, 23, 00, 24, 13, 13, 32, 31, 13, 13, 23, 00, 24, 23, 42, 24, 13, 13, 13, 13, 01],
                [04, 42, 42, 42, 42, 42, 42, 42, 42, 42, 42, 42, 42, 22, 21, 42, 42, 42, 42, 42, 42, 42, 42, 42, 42, 42, 42, 03],
                [04, 42, 20, 14, 14, 19, 42, 20, 14, 14, 14, 19, 42, 22, 21, 42, 20, 14, 14, 14, 19, 42, 20, 14, 14, 19, 42, 03],
                [04, 42, 24, 13, 32, 21, 42, 24, 13, 13, 13, 23, 42, 24, 23, 42, 24, 13, 13, 13, 23, 42, 22, 31, 13, 23, 42, 03],
                [04, 43, 42, 42, 22, 21, 42, 42, 42, 42, 42, 42, 42, 42, 42, 42, 42, 42, 42, 42, 42, 42, 22, 21, 42, 42, 43, 03],
                [08, 14, 19, 42, 22, 21, 42, 20, 19, 42, 20, 14, 14, 14, 14, 14, 14, 19, 42, 20, 19, 42, 22, 21, 42, 20, 14, 07],
                [10, 13, 23, 42, 24, 23, 42, 22, 21, 42, 24, 13, 13, 32, 31, 13, 13, 23, 42, 22, 21, 42, 24, 23, 42, 24, 13, 09],
                [04, 42, 42, 42, 42, 42, 42, 22, 21, 42, 42, 42, 42, 22, 21, 42, 42, 42, 42, 22, 21, 42, 42, 42, 42, 42, 42, 03],
                [04, 42, 20, 14, 14, 14, 14, 23, 24, 14, 14, 19, 42, 22, 21, 42, 20, 14, 14, 23, 24, 14, 14, 14, 14, 19, 42, 03],
                [04, 42, 24, 13, 13, 13, 13, 13, 13, 13, 13, 23, 42, 24, 23, 42, 24, 13, 13, 13, 13, 13, 13, 13, 13, 23, 42, 03],
				[04, 42, 42, 42, 42, 42, 42, 42, 42, 42, 42, 42, 42, 42, 42, 42, 42, 42, 42, 42, 42, 42, 42, 42, 42, 42, 42, 03],
                [06, 13, 13, 13, 13, 13, 13, 13, 13, 13, 13, 13, 13, 13, 13, 13, 13, 13, 13, 13, 13, 13, 13, 13, 13, 13, 13, 05]
            ]
        },
        {
            "id": 1,
            "width": 28,
            "height": 31,
            "super_pac_gum": {
                "duration": 10
            },
            "pac-man": {
                "id": 1,
                "start_pos": {
                    "x": 0,
                    "y": 0
                }
            },
            "ghost": [{
                "id": 1,
                "start_pos": {
                    "x": 0,
                    "y": 0
                }
            }, {
                "id": 2,
                "start_pos": {
                    "x": 0,
                    "y": 0
                }
            }, {
                "id": 3,
                "start_pos": {
                    "x": 0,
                    "y": 0
                }
            }, {
                "id": 4,
                "start_pos": {
                    "x": 0,
                    "y": 0
                }
            }],
            "map": [
                [0, 0, 0, 0, 0, 0, 0, 0, 0, 0, 0, 0, 0, 0, 0, 0, 0, 0, 0, 0, 0, 0, 0, 0, 0, 0, 0, 0],
                [0, 0, 0, 0, 0, 0, 0, 0, 0, 0, 0, 0, 0, 0, 0, 0, 0, 0, 0, 0, 0, 0, 0, 0, 0, 0, 0, 0],
                [0, 0, 0, 0, 0, 0, 0, 0, 0, 0, 0, 0, 0, 0, 0, 0, 0, 0, 0, 0, 0, 0, 0, 0, 0, 0, 0, 0],
                [0, 0, 0, 0, 0, 0, 0, 0, 0, 0, 0, 0, 0, 0, 0, 0, 0, 0, 0, 0, 0, 0, 0, 0, 0, 0, 0, 0],
                [0, 0, 0, 0, 0, 0, 0, 0, 0, 0, 0, 0, 0, 0, 0, 0, 0, 0, 0, 0, 0, 0, 0, 0, 0, 0, 0, 0],
                [0, 0, 0, 0, 0, 0, 0, 0, 0, 0, 0, 0, 0, 0, 0, 0, 0, 0, 0, 0, 0, 0, 0, 0, 0, 0, 0, 0],
                [0, 0, 0, 0, 0, 0, 0, 0, 0, 0, 0, 0, 0, 0, 0, 0, 0, 0, 0, 0, 0, 0, 0, 0, 0, 0, 0, 0],
                [0, 0, 0, 0, 0, 0, 0, 0, 0, 0, 0, 0, 0, 0, 0, 0, 0, 0, 0, 0, 0, 0, 0, 0, 0, 0, 0, 0],
                [0, 0, 0, 0, 0, 0, 0, 0, 0, 0, 0, 0, 0, 0, 0, 0, 0, 0, 0, 0, 0, 0, 0, 0, 0, 0, 0, 0],
                [0, 0, 0, 0, 0, 0, 0, 0, 0, 0, 0, 0, 0, 0, 0, 0, 0, 0, 0, 0, 0, 0, 0, 0, 0, 0, 0, 0],
                [0, 0, 0, 0, 0, 0, 0, 0, 0, 0, 0, 0, 0, 0, 0, 0, 0, 0, 0, 0, 0, 0, 0, 0, 0, 0, 0, 0],
                [0, 0, 0, 0, 0, 0, 0, 0, 0, 0, 0, 0, 0, 0, 0, 0, 0, 0, 0, 0, 0, 0, 0, 0, 0, 0, 0, 0],
                [0, 0, 0, 0, 0, 0, 0, 0, 0, 0, 0, 0, 0, 0, 0, 0, 0, 0, 0, 0, 0, 0, 0, 0, 0, 0, 0, 0],
                [0, 0, 0, 0, 0, 0, 0, 0, 0, 0, 0, 0, 0, 0, 0, 0, 0, 0, 0, 0, 0, 0, 0, 0, 0, 0, 0, 0],
                [0, 0, 0, 0, 0, 0, 0, 0, 0, 0, 0, 0, 0, 0, 0, 0, 0, 0, 0, 0, 0, 0, 0, 0, 0, 0, 0, 0],
                [0, 0, 0, 0, 0, 0, 0, 0, 0, 0, 0, 0, 0, 0, 0, 0, 0, 0, 0, 0, 0, 0, 0, 0, 0, 0, 0, 0],
                [0, 0, 0, 0, 0, 0, 0, 0, 0, 0, 0, 0, 0, 0, 0, 0, 0, 0, 0, 0, 0, 0, 0, 0, 0, 0, 0, 0],
                [0, 0, 0, 0, 0, 0, 0, 0, 0, 0, 0, 0, 0, 0, 0, 0, 0, 0, 0, 0, 0, 0, 0, 0, 0, 0, 0, 0],
                [0, 0, 0, 0, 0, 0, 0, 0, 0, 0, 0, 0, 0, 0, 0, 0, 0, 0, 0, 0, 0, 0, 0, 0, 0, 0, 0, 0],
                [0, 0, 0, 0, 0, 0, 0, 0, 0, 0, 0, 0, 0, 0, 0, 0, 0, 0, 0, 0, 0, 0, 0, 0, 0, 0, 0, 0],
                [0, 0, 0, 0, 0, 0, 0, 0, 0, 0, 0, 0, 0, 0, 0, 0, 0, 0, 0, 0, 0, 0, 0, 0, 0, 0, 0, 0],
                [0, 0, 0, 0, 0, 0, 0, 0, 0, 0, 0, 0, 0, 0, 0, 0, 0, 0, 0, 0, 0, 0, 0, 0, 0, 0, 0, 0],
                [0, 0, 0, 0, 0, 0, 0, 0, 0, 0, 0, 0, 0, 0, 0, 0, 0, 0, 0, 0, 0, 0, 0, 0, 0, 0, 0, 0],
                [0, 0, 0, 0, 0, 0, 0, 0, 0, 0, 0, 0, 0, 0, 0, 0, 0, 0, 0, 0, 0, 0, 0, 0, 0, 0, 0, 0],
                [0, 0, 0, 0, 0, 0, 0, 0, 0, 0, 0, 0, 0, 0, 0, 0, 0, 0, 0, 0, 0, 0, 0, 0, 0, 0, 0, 0],
                [0, 0, 0, 0, 0, 0, 0, 0, 0, 0, 0, 0, 0, 0, 0, 0, 0, 0, 0, 0, 0, 0, 0, 0, 0, 0, 0, 0],
                [0, 0, 0, 0, 0, 0, 0, 0, 0, 0, 0, 0, 0, 0, 0, 0, 0, 0, 0, 0, 0, 0, 0, 0, 0, 0, 0, 0],
                [0, 0, 0, 0, 0, 0, 0, 0, 0, 0, 0, 0, 0, 0, 0, 0, 0, 0, 0, 0, 0, 0, 0, 0, 0, 0, 0, 0],
                [0, 0, 0, 0, 0, 0, 0, 0, 0, 0, 0, 0, 0, 0, 0, 0, 0, 0, 0, 0, 0, 0, 0, 0, 0, 0, 0, 0],
                [0, 0, 0, 0, 0, 0, 0, 0, 0, 0, 0, 0, 0, 0, 0, 0, 0, 0, 0, 0, 0, 0, 0, 0, 0, 0, 0, 0],
                [0, 0, 0, 0, 0, 0, 0, 0, 0, 0, 0, 0, 0, 0, 0, 0, 0, 0, 0, 0, 0, 0, 0, 0, 0, 0, 0, 0]
            ]
        },
        {
            "id": 2,
            "width": 28,
            "height": 31,
            "super_pac_gum": {
                "duration": 10
            },
            "pac-man": {
                "id": 1,
                "start_pos": {
                    "x": 0,
                    "y": 0
                }
            },
            "ghost": [{
                "id": 1,
                "start_pos": {
                    "x": 0,
                    "y": 0
                }
            }, {
                "id": 2,
                "start_pos": {
                    "x": 0,
                    "y": 0
                }
            }, {
                "id": 3,
                "start_pos": {
                    "x": 0,
                    "y": 0
                }
            }, {
                "id": 4,
                "start_pos": {
                    "x": 0,
                    "y": 0
                }
            }],
            "map": [
                [0, 0, 0, 0, 0, 0, 0, 0, 0, 0, 0, 0, 0, 0, 0, 0, 0, 0, 0, 0, 0, 0, 0, 0, 0, 0, 0, 0],
                [0, 0, 0, 0, 0, 0, 0, 0, 0, 0, 0, 0, 0, 0, 0, 0, 0, 0, 0, 0, 0, 0, 0, 0, 0, 0, 0, 0],
                [0, 0, 0, 0, 0, 0, 0, 0, 0, 0, 0, 0, 0, 0, 0, 0, 0, 0, 0, 0, 0, 0, 0, 0, 0, 0, 0, 0],
                [0, 0, 0, 0, 0, 0, 0, 0, 0, 0, 0, 0, 0, 0, 0, 0, 0, 0, 0, 0, 0, 0, 0, 0, 0, 0, 0, 0],
                [0, 0, 0, 0, 0, 0, 0, 0, 0, 0, 0, 0, 0, 0, 0, 0, 0, 0, 0, 0, 0, 0, 0, 0, 0, 0, 0, 0],
                [0, 0, 0, 0, 0, 0, 0, 0, 0, 0, 0, 0, 0, 0, 0, 0, 0, 0, 0, 0, 0, 0, 0, 0, 0, 0, 0, 0],
                [0, 0, 0, 0, 0, 0, 0, 0, 0, 0, 0, 0, 0, 0, 0, 0, 0, 0, 0, 0, 0, 0, 0, 0, 0, 0, 0, 0],
                [0, 0, 0, 0, 0, 0, 0, 0, 0, 0, 0, 0, 0, 0, 0, 0, 0, 0, 0, 0, 0, 0, 0, 0, 0, 0, 0, 0],
                [0, 0, 0, 0, 0, 0, 0, 0, 0, 0, 0, 0, 0, 0, 0, 0, 0, 0, 0, 0, 0, 0, 0, 0, 0, 0, 0, 0],
                [0, 0, 0, 0, 0, 0, 0, 0, 0, 0, 0, 0, 0, 0, 0, 0, 0, 0, 0, 0, 0, 0, 0, 0, 0, 0, 0, 0],
                [0, 0, 0, 0, 0, 0, 0, 0, 0, 0, 0, 0, 0, 0, 0, 0, 0, 0, 0, 0, 0, 0, 0, 0, 0, 0, 0, 0],
                [0, 0, 0, 0, 0, 0, 0, 0, 0, 0, 0, 0, 0, 0, 0, 0, 0, 0, 0, 0, 0, 0, 0, 0, 0, 0, 0, 0],
                [0, 0, 0, 0, 0, 0, 0, 0, 0, 0, 0, 0, 0, 0, 0, 0, 0, 0, 0, 0, 0, 0, 0, 0, 0, 0, 0, 0],
                [0, 0, 0, 0, 0, 0, 0, 0, 0, 0, 0, 0, 0, 0, 0, 0, 0, 0, 0, 0, 0, 0, 0, 0, 0, 0, 0, 0],
                [0, 0, 0, 0, 0, 0, 0, 0, 0, 0, 0, 0, 0, 0, 0, 0, 0, 0, 0, 0, 0, 0, 0, 0, 0, 0, 0, 0],
                [0, 0, 0, 0, 0, 0, 0, 0, 0, 0, 0, 0, 0, 0, 0, 0, 0, 0, 0, 0, 0, 0, 0, 0, 0, 0, 0, 0],
                [0, 0, 0, 0, 0, 0, 0, 0, 0, 0, 0, 0, 0, 0, 0, 0, 0, 0, 0, 0, 0, 0, 0, 0, 0, 0, 0, 0],
                [0, 0, 0, 0, 0, 0, 0, 0, 0, 0, 0, 0, 0, 0, 0, 0, 0, 0, 0, 0, 0, 0, 0, 0, 0, 0, 0, 0],
                [0, 0, 0, 0, 0, 0, 0, 0, 0, 0, 0, 0, 0, 0, 0, 0, 0, 0, 0, 0, 0, 0, 0, 0, 0, 0, 0, 0],
                [0, 0, 0, 0, 0, 0, 0, 0, 0, 0, 0, 0, 0, 0, 0, 0, 0, 0, 0, 0, 0, 0, 0, 0, 0, 0, 0, 0],
                [0, 0, 0, 0, 0, 0, 0, 0, 0, 0, 0, 0, 0, 0, 0, 0, 0, 0, 0, 0, 0, 0, 0, 0, 0, 0, 0, 0],
                [0, 0, 0, 0, 0, 0, 0, 0, 0, 0, 0, 0, 0, 0, 0, 0, 0, 0, 0, 0, 0, 0, 0, 0, 0, 0, 0, 0],
                [0, 0, 0, 0, 0, 0, 0, 0, 0, 0, 0, 0, 0, 0, 0, 0, 0, 0, 0, 0, 0, 0, 0, 0, 0, 0, 0, 0],
                [0, 0, 0, 0, 0, 0, 0, 0, 0, 0, 0, 0, 0, 0, 0, 0, 0, 0, 0, 0, 0, 0, 0, 0, 0, 0, 0, 0],
                [0, 0, 0, 0, 0, 0, 0, 0, 0, 0, 0, 0, 0, 0, 0, 0, 0, 0, 0, 0, 0, 0, 0, 0, 0, 0, 0, 0],
                [0, 0, 0, 0, 0, 0, 0, 0, 0, 0, 0, 0, 0, 0, 0, 0, 0, 0, 0, 0, 0, 0, 0, 0, 0, 0, 0, 0],
                [0, 0, 0, 0, 0, 0, 0, 0, 0, 0, 0, 0, 0, 0, 0, 0, 0, 0, 0, 0, 0, 0, 0, 0, 0, 0, 0, 0],
                [0, 0, 0, 0, 0, 0, 0, 0, 0, 0, 0, 0, 0, 0, 0, 0, 0, 0, 0, 0, 0, 0, 0, 0, 0, 0, 0, 0],
                [0, 0, 0, 0, 0, 0, 0, 0, 0, 0, 0, 0, 0, 0, 0, 0, 0, 0, 0, 0, 0, 0, 0, 0, 0, 0, 0, 0],
                [0, 0, 0, 0, 0, 0, 0, 0, 0, 0, 0, 0, 0, 0, 0, 0, 0, 0, 0, 0, 0, 0, 0, 0, 0, 0, 0, 0],
                [0, 0, 0, 0, 0, 0, 0, 0, 0, 0, 0, 0, 0, 0, 0, 0, 0, 0, 0, 0, 0, 0, 0, 0, 0, 0, 0, 0]
            ]
        }
    ]
}
